** ** ** ** ** ** ** 

** ** ** ██═██ ** ** 
          ║          
** ** ** ██ ** ** ** 
          ║          
** ** ** ██ ** ** ** 
                     
** ** ** ** ** ** ** 
                     
** ** ** ** ** ** ** 
                     
** ** ** ** ** ** ** 
                     

