** ██ ** ██═██ ██ ** 
    ║     ║     ║    
** ██═██═██═██═██ ** 
    ║        ║       
** ██ ** ** ██ ** ** 
    ║        ║       
** ██ ** ██═██ ** ** 
             ║       
** ** ** ** ██ ██ ** 
             ║  ║    
** ** ** ** ██═██═██ 
             ║       
** ** ** ** ██ ** ** 
                     

