** ** ** ** ** ** ** 
                     
** ** ** ** ** ** ** 
                     
** ** ** ** ** ** ** 
                     
██ ** ** ██═██ ** ** 
 ║        ║  ║       
██═██═██═██ ██ ** ** 
    ║        ║       
** ██ ** ** ██═██═██ 
    ║        ║  ║    
** ██ ** ██═██═██═██ 
                     

